xxxxxxxxx
x       e
x xxxx xx
x     x x
xx x xx x
s x   x x
x   x   x
xxxxxxxxx