xxsxxxxxx
x       x
xxx xxx x
x   x x x
x xxx x x
x   x   x
xxxexxxxx